border_size=1
usage=map

Xv          , Xv          , Xv          , Xv          , Xv          , Xv          , Xv          , Xv          , Xv          , Xv          , Xv          , Xv          , Xv          , Xv          , Xv          , Xv          , Xv          , Xv          , Ql          , Xv          , Xv          , Xv          , Xv          , Xv          , Xv          , Xv          , Xv          , Xv          , Xv          , Xv          , Xv          , Xv          , Xv          , Xv          , Xv          , Xv          , Xv          , Xv          
Xv          , Xv          , Xv          , Xv          , Xv          , Xv          , Xv          , Xv          , Xv          , Xv          , Xv          , Xv          , Xv          , Xv          , Xv          , Xv          , Ql          , Ql          , Uu^Uf       , Ql          , Ql          , Xv          , Xv          , Xv          , Xv          , Xv          , Xv          , Xv          , Xv          , Xv          , Xv          , Xv          , Xv          , Xv          , Xv          , Xv          , Xv          , Xv          
Xv          , Xv          , Xv          , Xv          , Xv          , Xv          , Xv          , Xv          , Xv          , Xv          , Xv          , Xv          , Xv          , Xv          , Xu          , Xu          , Ql          , Re          , Uu^Vud      , Re^Dr       , Ql          , Xu          , Xu          , Xv          , Xv          , Xv          , Xv          , Xv          , Xv          , Xv          , Xv          , Xv          , Xv          , Xv          , Xv          , Xv          , Xv          , Xv          
Xv          , Xv          , Xv          , Xv          , Xv          , Xv          , Xv          , Xv          , Xv          , Xv          , Xv          , Xv          , Xu          , Xu          , Ql          , Ql          , Re          , Re          , Rd          , Re          , Re          , Ql          , Ql          , Xu          , Xu          , Xv          , Xv          , Xv          , Xv          , Xv          , Xv          , Xv          , Xv          , Xv          , Xv          , Xv          , Xv          , Xv          
Xv          , Xv          , Xv          , Xv          , Xv          , Xv          , Xv          , Xv          , Xv          , Xv          , Qxu         , Qxu         , Ur          , Uh          , Ur          , Ql^Bs/      , Ql          , Re^Dr       , Rd          , Re^Dr       , Ql          , Ql^Bs\      , Ur          , Uh          , Ur          , Qxu         , Qxu         , Xv          , Xv          , Xv          , Xv          , Xv          , Xv          , Xv          , Xv          , Xv          , Xv          , Xv          
Xv          , Xv          , Xv          , Xv          , Xv          , Xv          , Xv          , Xv          , Xu          , Qxu         , Ur          , Qxu^Bs/     , Qxu         , Ur          , Ur          , Xu          , Uu^Uf       , Ur          , Rd          , Ur          , Uu^Uf       , Xu          , Ur          , Ur          , Qxu         , Qxu^Bs\     , Ur          , Qxu         , Xu          , Xv          , Xv          , Xv          , Xv          , Xv          , Xv          , Xv          , Xv          , Xv          
Xv          , Xv          , Xv          , Xv          , Xv          , Xv          , Xu          , Xu          , Uu^Vud      , Xu          , Ur          , Ur          , Ur          , Qxu^Bs/     , Qxu         , Ur          , Ur          , Ur          , Kud         , Ur          , Ur          , Ur          , Qxu         , Qxu^Bs\     , Ur          , Ur          , Ur          , Xu          , Uu^Vu       , Xu          , Xu          , Xv          , Xv          , Xv          , Xv          , Xv          , Xv          , Xv          
Xv          , Xv          , Xv          , Xv          , Xu          , Xu          , Re          , Re          , Re          , Ur          , Ur          , Uh          , Uu          , Uh          , Ur          , Ur          , Ql          , Cud         , Cud         , Cud         , Ql          , Ur          , Ur          , Uh          , Uu          , Uh          , Ur          , Ur          , Re          , Re          , Re          , Xu          , Xu          , Xv          , Xv          , Xv          , Xv          , Xv          
Xv          , Xv          , Mm^Xm       , Xu          , Re          , Re          , Uu          , Uu^Uf       , Uh          , Xu          , Xu          , Ur          , Ur          , Ur          , Uh          , Ur          , Ur          , Ql          , Ql          , Ql          , Ur          , Ur          , Uh          , Ur          , Ur          , Ur          , Xu          , Xu          , Uh          , Uu^Uf       , Uu          , Re          , Re          , Xu          , Xu          , Xv          , Xv          , Xv          
Mm^Xm       , Mm^Xm       , Hh^Fmw      , Re          , Mm          , Xu          , Xu          , Uu          , Uu          , Uh          , Uu          , Ur          , Uu          , Xu          , Uu^Uf       , Ur          , Uu          , Ur          , Ur          , Ur          , Uu          , Uu          , Uu^Uf       , Xu          , Uu          , Ur          , Uu          , Uh          , Uu          , Uu          , Xu          , Xu          , Hh^Fmw      , Re          , Ms          , Mm^Xm       , Mm^Xm       , Xv          
Mm^Xm       , Hh^Fmf      , Aa          , Re          , Ww          , Aa^Fpa      , Mm^Xm       , Xu          , Xu          , Uh          , Uu          , Ur          , Uh          , Xu          , Uu          , Uu^Uf       , Uh          , Ql          , Uh          , Uu^Vu       , Uh          , Uu^Uf       , Uu          , Xu          , Uh          , Ur          , Uu          , Uh          , Xu          , Xu          , Mm^Xm       , Mm^Xm       , Aa          , Re          , Gg          , Ha          , Mm          , Mm^Xm       
Mm^Xm       , Ms          , Aa          , Re          , Aa          , Ww          , Aa^Fpa      , Hh          , Kud         , Xu          , Cud         , Ur          , Uu          , Uu          , Xu          , Uh          , Xu          , Xu          , Xu          , Xu          , Xu          , Uh          , Xu          , Uu          , Uu          , Ur          , Co          , Xu          , Ko          , Hh          , Ha          , Aa^Fpa      , Gg          , Gg          , Gs^Fp       , Aa          , Ha          , Mm^Xm       
Mm^Xm       , Mm          , Re          , Re          , Aa          , Ai          , Ai          , Gs^Fp       , Mm          , Cud         , Rp          , Re          , Re          , Xu          , Mm^Xm       , Xu          , Wo          , Wo          , Ww          , Mm          , Ha          , Xu          , Mm^Xm       , Xu          , Re          , Re          , Rd          , Co          , Gs^Fp       , Gs^Fp       , Gg          , Gg          , Re          , Mm          , Aa          , Aa          , Ha^Fma      , Mm^Xm       
Mm^Xm       , Hh^Fms      , Gs^Fp       , Aa^Vha      , Gs^Fp       , Aa          , Ggf         , Ww          , Gg          , Rp          , Aa          , Rp          , Gg          , Gs^Fp       , Ms          , Wo          , Wo          , Ai          , Aa^Vca      , Aa^Fpa      , Ai          , Ms          , Mm^Xm       , Aa^Fpa      , Aa          , Rd          , Gg          , Gg          , Ggf         , Gg          , Aa          , Gs^Fp       , Gg^Vl       , Re          , Ggf         , Ha          , Ms          , Mm^Xm       
Mm^Xm       , Ms          , Re          , Re          , Gs^Fdw      , Gg          , Gg          , Wwf         , Gg          , Gs^Fp       , Aa          , Rr          , Rr          , Hh          , Ds          , Wwr         , Ww          , Ww          , Ww^Bw/      , Ggf         , Wwf         , Ww          , Ww          , Ms          , Rd          , Rd          , Rd          , Gs^Fms      , Gs^Fp       , Aa          , Aa          , Gs^Fp       , Hh^Fp       , Re          , Mm^Xm       , Hh^Fms      , Mm          , Mm^Xm       
Mm^Xm       , Hh^Fp       , Mm^Xm       , Mm^Xm       , Mm^Xm       , Gs^Fp       , Mm          , Ww          , Ai          , Aa          , Ggf         , Gs^Fp       , Rr          , Ha^Fda      , Aa^Fpa      , Ww          , Gs^Fp       , Re          , Wwr         , Wo          , Wwr         , Wwf         , Re          , Ww^Bw/      , Ww          , Aa          , Aa^Fda      , Rd          , Rd          , Gg          , Ha^Fma      , Ms          , Mm^Xm       , Mm^Xm       , Ke          , Mm^Xm       , Gg          , Mm^Xm       
Mm^Xm       , Mm          , Rp          , Khr         , Chr         , Mm^Xm       , Mm          , Gs^Fp       , Re^Vct      , Ai          , Ww          , Gg          , Rr          , Aa          , Aa          , Ww          , Hh^Fmw      , Re          , Ds          , Wo          , Ms          , Re          , Gs^Fp       , Gs^Fms      , Ww          , Ai          , Aa          , Gg          , Ha          , Rd          , Rd          , Mm          , Gs^Fp       , Ce          , Re          , Ggf         , Gs^Fp       , Mm^Xm       
Mm^Xm       , Hh^Fms      , Ggf         , Rp          , Gg          , Gs^Fp       , Aa^Fpa      , Ha          , Gg          , Re          , Rp          , Ww^Bw/      , Ww          , Gg          , Wwf         , Ww          , Wwf         , Re          , Re          , Gs^Fp       , Co          , Re          , Wwf         , Ww          , Mm          , Gs^Fp       , Ha^Vhha     , Re          , Aa          , Gs^Fp       , Hh^Fp       , Rd          , Gg          , Re          , Ha          , Gs^Fp       , Ha          , Mm^Xm       
Mm^Xm       , Aa          , Aa^Fpa      , Gg          , Aa          , Gs^Fp       , Ggf         , Gs^Fp       , Rr          , Rp          , Gg          , Gg          , Hh^Fp       , Ww          , Mm^Xm       , Re          , Aa          , Ww          , Ai          , Co          , Ko          , Co          , Ww          , Wwf         , Gg          , Hh          , Re          , Re          , Re          , Aa^Fpa      , Aa          , Rd          , Mm          , Ggf         , Gg          , Aa^Fda      , Gs^Fp       , Mm^Xm       
Mm^Xm       , Gs^Fp       , Aa^Voa      , Re          , Ms          , Mm          , Rr          , Rp          , Mm          , Hh          , Gg          , Gs^Fmf      , Aa          , Mm          , Mm^Xm       , Ha          , Aa          , Wwf         , Wo          , Wo          , Wo          , Wo          , Wo          , Ww          , Wwf         , Re          , Gs^Fms      , Gg          , Ha^Fma      , Gg          , Gg          , Rd          , Ha^Fpa      , Ms          , Re          , Re          , Re          , Mm^Xm       
Mm^Xm       , Mm          , Re          , Re          , Ms          , Hh^Fp       , Rr          , Gs^Fp       , Gg          , Ggf         , Gs^Fp       , Aa          , Gs^Fp       , Ha          , Mm          , Mm^Xm       , Ms          , Wwr         , Ww          , Wo          , Wo          , Wo          , Wwf         , Ww          , Ds^Dr       , Ds          , Ggf         , Mm          , Ms          , Mm          , Gg          , Rd          , Aa^Fpa      , Mm          , Gs^Fp       , Re^Vct      , Aa          , Mm^Xm       
Mm^Xm       , Gs^Fp       , Ggf         , Aa          , Aa          , Aa          , Rp          , Gg          , Gg^Wm       , Gg          , Re^Gvs      , Gs^Fp       , Ggf         , Gg          , Ha          , Mm^Xm       , Mm^Xm       , Wwf         , Wwf         , Ww          , Ai          , Wo          , Wwf         , Ds          , Mm^Xm       , Mm          , Aa^Fpa      , Gg          , Gg          , Gs^Fp       , Ggf         , Rd          , Gg          , Aa          , Gg          , Ggf         , Ms          , Mm^Xm       
Mm^Xm       , Mm          , Gg          , Gg          , Gs^Fp       , Ha^Fma      , Rp          , Gg          , Gg^Vh       , Re^Gvs      , Re^Gvs      , Gg          , Hh^Fmf      , Aa^Fda      , Mm          , Ha^Fpa      , Hh          , Aa^Fpa      , Wwf         , Ww          , Wo          , Ww          , Wwf         , Wwr         , Mm^Xm       , Ha^Fpa      , Ha          , Ggf         , Gg^Vh       , Gg^Wm       , Re^Gvs      , Rd          , Gs^Fp       , Hh          , Gg          , Aa^Fpa      , Mm          , Mm^Xm       
Mm^Xm       , Mm          , Gg          , Gs^Fp       , Hh          , Gg          , Rr          , Ggf         , Ha          , Hh^Fmw      , Mm^Xm       , Hh^Fp       , Mm^Xm       , Mm^Xm       , Ha          , Ms          , Wwf         , Wwr         , Ww          , Ww          , Wo          , Ww          , Wwf         , Ha          , Ha^Fpa      , Mm^Xm       , Mm^Xm       , Aa^Fpa      , Gs^Fp       , Re^Gvs      , Gg          , Rd          , Rd          , Gs^Fp       , Gg          , Hh^Fp       , Gs^Fp       , Mm^Xm       
Mm^Xm       , Ha^Fpa      , Chr         , Hh          , Rr          , Rp          , Aa^Fpa      , Ms          , Ds^Dr       , Mm^Xm       , Wwr         , Mm^Xm       , Wwf         , Wwf         , Ww          , Wwf         , Wo          , Ww          , Ai          , Wo          , Ww          , Ww          , Wo          , Wwf         , Wwr         , Ms          , Hh          , Mm^Xm       , Ds          , Hh          , Ds          , Ggf         , Rd          , Gs^Fp       , Ce          , Gs^Fp       , Hh^Fdw      , Mm^Xm       
Ms          , Hh^Fms      , 1 Khr       , Chr         , Chr         , Rp          , Ds          , Ds          , Wwf         , Wwf         , Wo          , Ww          , Wo          , Wo          , Wo          , Wo          , Wo          , Ai          , Ww          , Ww          , Ai          , Wo          , Wo          , Wo          , Wo          , Wwf         , Wwf         , Ds          , Wwr         , Wwf         , Wwf         , Rd          , Ce          , Ce          , 2 Ke        , Hh^Fdw      , Mm          , Mm^Xm       
Ms          , Aa          , Aa^Fpa      , Rp          , Chw         , Wwf         , Wwf         , Wwf         , Ww          , Ww          , Wo          , Wo          , Wo          , Wo          , Wo          , Wo          , Ww          , Ww          , Aa^Vea      , Ww          , Ww          , Wo          , Wo          , Wo          , Wo          , Wo          , Wo          , Ww          , Ww          , Ww          , Wwf         , Wwf         , Ce          , Re          , Hh^Fdw      , Mm          , Mm^Xm       , Mm^Xm       
Xv          , Hh^Fp       , Ggf         , Gg^Vl       , Wwr         , Ww          , Ww          , Wwf         , Wwf         , Ww          , Wo          , Wo          , Wo          , Wo          , Wo          , Wo          , Wwr         , Ai          , Ha^Fpa      , Gg          , Ww          , Wo          , Wo          , Wo          , Wo          , Wo          , Wo          , Ai          , Ai          , Wwf         , Ww          , Ww          , Ai          , Hh^Vc       , Mm^Xm       , Mm^Xm       , Xv          , Xv          
Xv          , Xv          , Xv          , Ww^Bw\      , Wo          , Ww          , Wo          , Ww          , Ww          , Ai          , Ai          , Ai          , Ai          , Wo          , Wo          , Wwr         , Mm^Xm       , Mm^Xm       , Mm^Xm       , Mm^Xm       , Mm^Xm       , Wwr         , Wo          , Wo          , Wo          , Wo          , Ww          , Ai          , Ww          , Ww          , Wo          , Ai          , Wo          , Wwr         , Xv          , Xv          , Xv          , Xv          
Xv          , Xv          , Xv          , Xv          , Xv          , Wo          , Wo          , Wo          , Ai          , Ww          , Ww          , Ww          , Ai          , Wo          , Ww          , Ww          , Mm^Xm       , Wwr         , Ww          , Wwr         , Mm^Xm       , Ww          , Ww          , Wo          , Ai          , Ai          , Ww          , Ww          , Ai          , Wo          , Wo          , Wo          , Xv          , Xv          , Xv          , Xv          , Xv          , Xv          
Xv          , Xv          , Xv          , Xv          , Xv          , Xv          , Xv          , Wo          , Wo          , Ai          , Wo          , Ww          , Ww          , Wo          , Wwf         , Mm^Xm       , Ha^Fma      , Ww          , Ai          , Ai          , Hh^Fp       , Mm^Xm       , Wwf         , Wo          , Ww          , Ww          , Wo          , Wo          , Wo          , Wo          , Xv          , Xv          , Xv          , Xv          , Xv          , Xv          , Xv          , Xv          
Xv          , Xv          , Xv          , Xv          , Xv          , Xv          , Xv          , Xv          , Xv          , Wo          , Wo          , Wo          , Ww          , Wwf         , Wwf         , Mm^Xm       , Mm^Xm       , Gs^Fmf      , Re          , Aa^Fpa      , Mm^Xm       , Mm^Xm       , Wwf         , Wwf         , Ww          , Ww          , Wo          , Wo          , Xv          , Xv          , Xv          , Xv          , Xv          , Xv          , Xv          , Xv          , Xv          , Xv          
Xv          , Xv          , Xv          , Xv          , Xv          , Xv          , Xv          , Xv          , Xv          , Xv          , Xv          , Wo          , Wo          , Ww          , Ww          , Wwf         , Wwf         , Aa          , Gg^Vh       , Wwf         , Wwf         , Wwf         , Ww          , Ww          , Wo          , Wo          , Xv          , Xv          , Xv          , Xv          , Xv          , Xv          , Xv          , Xv          , Xv          , Xv          , Xv          , Xv          
Xv          , Xv          , Xv          , Xv          , Xv          , Xv          , Xv          , Xv          , Xv          , Xv          , Xv          , Xv          , Xv          , Wo          , Wo          , Ai          , Ai          , Wwf         , Ww^Bw/      , Aa          , Ai          , Ai          , Wo          , Wo          , Xv          , Xv          , Xv          , Xv          , Xv          , Xv          , Xv          , Xv          , Xv          , Xv          , Xv          , Xv          , Xv          , Xv          
Xv          , Xv          , Xv          , Xv          , Xv          , Xv          , Xv          , Xv          , Xv          , Xv          , Xv          , Xv          , Xv          , Xv          , Xv          , Wo          , Wo          , Wo          , Ai          , Ww          , Wo          , Wo          , Xv          , Xv          , Xv          , Xv          , Xv          , Xv          , Xv          , Xv          , Xv          , Xv          , Xv          , Xv          , Xv          , Xv          , Xv          , Xv          
Xv          , Xv          , Xv          , Xv          , Xv          , Xv          , Xv          , Xv          , Xv          , Xv          , Xv          , Xv          , Xv          , Xv          , Xv          , Xv          , Xv          , Wo          , Wo          , Wo          , Xv          , Xv          , Xv          , Xv          , Xv          , Xv          , Xv          , Xv          , Xv          , Xv          , Xv          , Xv          , Xv          , Xv          , Xv          , Xv          , Xv          , Xv          
Xv          , Xv          , Xv          , Xv          , Xv          , Xv          , Xv          , Xv          , Xv          , Xv          , Xv          , Xv          , Xv          , Xv          , Xv          , Xv          , Xv          , Xv          , Xv          , Xv          , Xv          , Xv          , Xv          , Xv          , Xv          , Xv          , Xv          , Xv          , Xv          , Xv          , Xv          , Xv          , Xv          , Xv          , Xv          , Xv          , Xv          , Xv          
Xv          , Xv          , Xv          , Xv          , Xv          , Xv          , Xv          , Xv          , Xv          , Xv          , Xv          , Xv          , Xv          , Xv          , Xv          , Xv          , Xv          , Xv          , Xv          , Xv          , Xv          , Xv          , Xv          , Xv          , Xv          , Xv          , Xv          , Xv          , Xv          , Xv          , Xv          , Xv          , Xv          , Xv          , Xv          , Xv          , Xv          , Xv          
