border_size=1
usage=map

Ms          , Ms          , Mm^Xm       , Ms          , Aa^Fpa      , Aa^Fpa      , Aa          , Aa          , Gg          , Ww          , Ai          , Ai          , Aa          , Aa          , Ms          , Aa          , Aa          , Aa          , Gg          , Ms          , Hh          , Mm          , Gs^Fp       , Aa          , Aa          , Aa          , Aa          
Mm^Xm       , Mm^Xm       , Mm          , Ms          , Hh^Fds      , Gs^Fds      , Cv          , Gg          , Gg          , Ww          , Ww          , Ww          , Gg          , Aa          , Aa^Vha      , Aa^Fpa      , Gg          , Gg          , Gs^Fp       , Gg          , Gg          , Gg          , Gs^Fp       , Gg          , Gg          , Aa          , Aa          
Mm^Xm       , Ms          , Gg          , Aa^Fpa      , 1 Kv        , Cv          , Rr          , Ggf         , Ai          , Ai          , Aa^Fpa      , Gg          , Ggf         , Gg          , Gg          , Aa^Fma      , Gg          , Gs^Fp       , Aa          , Gs^Fp       , Gg          , Ggf         , Gg          , Gs^Fp       , Hh          , Gg          , Aa          
Aa^Fpa      , Ha^Vhha     , Gs^Fds      , Gg          , Cv          , Cv          , Rr          , Ai          , Aa          , Ha^Fda      , Aa^Fpa      , Gs^Fp       , Ggf         , Gg          , Hh          , Gg          , Gg          , Gg          , Gg          , Aa          , Ms          , Gg          , Gg          , Gg^Ve       , Hh          , Gg          , Gg          
Aa          , Aa          , Gg          , Cv          , Ggf         , Rr          , Ai          , Ai^Bw\      , Rr          , Gs^Fp       , Gg          , Gs^Fp       , Gg          , Gg          , Rr          , Mm          , Gg          , Gg          , Gs^Fp       , Aa          , Gg          , Gg          , Mm          , Gg          , Gg          , Gg          , Ggf         
Aa          , Aa^Fpa      , Gg          , Gg          , Mm          , Ww          , Gg          , Aa          , Gg          , Rr          , Rr          , Gg^Ve       , Rr          , Rr          , Mm          , Rr          , Rr          , Aa          , Aa^Fpa      , Aa^Fpa      , Gg          , Gs^Fp       , Mm          , Gs^Fp       , Gg          , Ggf         , Gg          
Aa^Fpa      , Gg          , Ggf         , Gs^Fp       , Ms          , Ww          , Gs^Fp       , Gg          , Gg          , Gs^Fp       , Gg          , Rr          , Gg          , Gg          , Gg          , Aa          , Aa^Fpa      , Rr          , Rr          , Gs^Fp       , Gg          , Gg          , Gg          , Gs^Fp       , Gg          , Ggf         , Wo          
Gs^Fp       , Ggf         , Gg          , Gg          , Ww          , Ww          , Mm          , Hh          , Gg          , Gg          , Aa^Fpa      , Aa          , Gg          , Gg          , Mm          , Aa          , Re          , Re          , Gg          , Rr          , Rr          , Gg          , Ss          , Gg          , Ss          , Ww          , Wo          
Aa^Fpa      , Ggf         , Gg          , Ss          , Ss          , Gg          , Gg          , Gg          , Gg          , Aa          , Aa^Fpa      , Gs^Fp       , Gg^Vl       , Gg          , Gg          , Ms          , Ur          , Re          , Khr         , Chr         , Ss          , Rr          , Rr          , Ss          , Ss^Vhs      , Wwr         , Gg          
Ha          , Aa          , Gg          , Ss^Vhs      , Ss          , Gg          , Gg          , Ggf         , Ggf         , Mm          , Hh          , Gs^Fp       , Gs^Fp       , Gg          , Gg          , Uh          , Qxu         , Qxu         , Uu^Uf       , Chs         , Rr          , Rr          , Gg          , Gg          , Gg          , Gg          , Gg          
Wo          , Ai          , Ww          , Ww          , Gg          , Gg          , Hh          , Gg          , Gg          , Ggf         , Gg          , Gs^Fp       , Gs^Fp       , Gg          , Gg          , Ur          , Re          , Qxu         , Qxu^Bs/     , Rp          , Gg          , Gg          , Qxu         , Gg          , Gg          , Gg          , Gg          
Wo          , Ww          , Gg          , Gg          , Mm          , Gs^Fp       , Gs^Fp       , Gg          , Mm          , Gg          , Gg          , Gg          , Rp          , Gg          , Gs^Fp       , Re          , Rr          , Rr          , Re          , Qxu         , Qxu         , Qxu         , Uu^Vud      , Qxu         , Ur          , Gg          , Gg          
Wo          , Ww          , Wwf         , Mm^Xm       , Mm^Xm       , Ww          , Ww          , Ms          , Mm          , Gg          , Hh^Fds      , Rp^Vhc      , Re          , Rp          , Rr          , Rp          , Aa          , Gg          , Gg          , Re          , Re          , Gs^Fp       , Gs^Fp       , Ur          , Gg          , Gg          , Hh          
Gg          , Ww          , Gg          , Ww          , Ww          , Wo          , Wo          , Ww          , Gg          , Gg          , Rd          , Re          , Re          , Re          , Ha^Fpa      , Aa          , Mm          , Ms          , Mm          , Re          , Wwf         , Gg          , Aa          , Aa          , Aa^Fpa      , Ha          , Hh          
Gg          , Gg          , Re^Gvs      , Gg^Vh       , Gg          , Ww          , Gg^Wm       , Ww          , Ww^Bw/      , Rd          , Gs^Fp       , Rd          , Rd          , Gg^Vh       , Re^Gvs      , Re          , Re^Gvs      , Re          , Ww          , Wwf         , Re          , Ww          , Ai          , Ai          , Ww          , Aa^Fpa      , Ggf         
Gg          , Ggf         , Re^Gvs      , Re^Gvs      , Gs^Fp       , Ggf         , Rd          , Rd          , Gg          , Ww          , Wo          , Re          , Re^Gvs      , Re^Gvs      , Ww          , Re^Gvs      , Ww          , Ww          , Re          , Re          , Re          , Aa^Fpa      , Aa          , Ww          , Gs^Fp       , Ww          , Ww          
Gg          , Gg          , Ke          , Ce          , Rd          , Rd          , Gs^Fp       , Aa^Fpa      , Aa          , Gg          , Mm^Xm       , Ww          , Wwf         , Ww          , Re^Gvs      , Ww          , Re^Gvs      , Re          , Ggf         , Ggf         , Re          , Ms          , Aa          , Gs^Fp       , Ggf         , Hh          , Hh          
Aa^Fpa      , Gg          , Aa          , Ce          , Aa^Fpa      , Rd          , Rd          , Aa^Fpa      , Gg          , Ha          , Mm          , Mm^Xm       , Hh          , Re          , Ggf         , Re^Gvs      , Gs^Fp       , Gs^Fp       , Gs^Fp       , Gs^Fp       , Re          , Aa          , Ggf         , Gs^Fp       , Gg          , Hh^Vo       , Hh          
Ha^Fda      , Gg          , Gg          , Aa          , Gg          , Gg          , Gg          , Rd          , Rd          , Gg          , Gg          , Ha^Voa      , Aa          , Gg          , Gg          , Ggf         , Gg          , Gg          , Gg          , Re          , Mm          , Mm          , Gs^Fp       , Gs^Fp       , Gg          , Aa          , Aa^Fpa      
Aa          , Aa          , Gs^Fp       , Gg          , Aa          , Gg          , Gg          , Gg          , Aa^Fpa      , Rd          , Rd          , Aa          , Ms          , Mm          , Rd          , Rd          , Rd          , Gg^Wm       , Re          , Re          , Gg          , Gs^Fp       , Re          , Gg          , Gs^Fp       , Aa^Fpa      , Ds^Dr       
Aa          , Aa          , Gs^Fp       , Gg          , Ms          , Aa^Fpa      , Gg          , Gg          , Ha          , Aa^Fpa      , Aa          , Rd          , Rd          , Rd          , Gg          , Gg^Vo       , Hh^Fp       , Rd          , Rd          , Gs^Fp       , Gg          , Re          , Gg          , Gg          , Aa          , Gs^Fp       , Ms          
Ha^Fda      , Gs^Fp       , Gg          , Gg          , Aa          , Mm          , Aa          , Gg          , Ms          , Aa          , Gg          , Gg          , Aa          , Gg          , Gg          , Hh          , Gs^Fp       , Gg          , Gg          , Rd          , Rd          , Re          , Co          , Co          , Ggf         , Ha^Voa      , Ms          
Ha^Fda      , Gg          , Gs^Fp       , Gg          , Gg          , Ms          , Aa          , Gg          , Gg          , Aa          , Gg          , Hh          , Ha          , Aa          , Gg          , Gs^Fp       , Gs^Fp       , Gg          , Gg          , Gg          , Re          , Co          , 2 Ko        , Gs^Fp       , Aa^Fpa      , Ms          , Mm          
Ms          , Aa^Fpa      , Ms^Vhha     , Aa          , Gg          , Gg          , Gg          , Gg          , Gg          , Gg          , Hh^Vhh      , Gg          , Gg          , Hh          , Gg          , Gg          , Gg          , Gg          , Gs^Fp       , Re          , Co          , Co          , Gs^Fp       , Gs^Fp       , Aa^Fpa      , Mm          , Ms          
Mm          , Gg          , Gg          , Aa          , Gg          , Gg          , Aa^Fpa      , Gg          , Gg          , Gs^Fp       , Aa          , Aa          , Gs^Fp       , Gg          , Gs^Fp       , Gg          , Gs^Fp       , Gg          , Gs^Fp       , Gs^Fp       , Gs^Fp       , Hh^Fp       , Hh^Fp       , Ms          , Hh^Fp       , Mm          , Ms          
Mm          , Ms          , Gg          , Gg          , Gg          , Gg          , Gg          , Gs^Fp       , Gg          , Gs^Fp       , Aa^Fpa      , Aa^Fpa      , Gs^Fp       , Gg          , Gg          , Gg          , Gs^Fp       , Gs^Fp       , Mm          , Mm          , Ms          , Mm          , Ms          , Hh^Fp       , Mm          , Mm          , Mm          
